S....#....
.##..#..#.
....##..#.
##.....#..
..###..#..
..#.......
..#.####..
..#....#.G