S...#...
.#.#.#..
.#...#..
.###.#..
...#...G